111111111111111111111111111111111111111111111111111111111111
100000000000000000000000000000000000000000000000000000000001
100000000000000000000000000000000000000000000000000000000001
100000000000000000000000000000000000000000000000000000000001
100000000000000000000000000000000000000000000000000000000001
100000000000000000000000000000000000000000000000000000000001
100000000000000000000000000000000000000000000000000000000001
100000000000000000000000000000000000000000000000000000000001
100000000000000000000000000000000000000000000000000000000001
100000000000000111111111111111111111111111110000000000000001
100000000000000111111111111111111111111111110000000000000001
100000000000000111111111111111111111111111110000000000000001
100000000000000111111111111111111111111111110000000000000001
100000000000000111111111111111111111111111110000000000000001
100000000000000111111111111111111111111111110000000000000001
100000000000000111111111111111111111111111110000000000000001
100000000000000111111111111111111111111111110000000000000001
100000000000000111111111111111111111111111110000000000000001
100000000000000111111111111111111111111111110000000000000001
100000000000000111111111111111111111111111110000000000000001
100000000000000111111111111111111111111111110000000000000001
100000000000000111111111111111111111111111110000000000000001
100000000000000111111111111111111111111111110000000000000001
100000000000000111111111111111111111111111110000011111111111
100000000000000000000111111111111111110000000000000000000001
100000000000000000000111111111111111110000000000000000000001
100000000000000000000111111111111111110000000000000000000001
100000000000000000000111111111111111110000000000000000000001
100000000000000000000111111111111111110000000000000000000001
100000000000000000000111111111111111110000000000000000000001
100000000000000000000111111111111111110000000000000000000001
100000000000000000000111111111111111110000000000000000000001
100000000000000000000111111111111111110000000000000000000001
100000000000000000000111111111111111110000000000000000000001
100000000000000000000111111111111111110000000000000000000001
100000000000000000000111111111111111110000000000000000000001
100000000000000000000111111111111111110000000000000000000001
100000000000000000000111111111111111110000000000000000000001
100000000000000000000111111111111111110000000000000000000001
111111111111111111111111111111111111111111111111111111111111

111111111111111111111111111111111111111111111111111111111111
100000000000000000000000000000000000000000000000000000000001
100000000000000000000000000000000000000000000000000000000001
100000000000000000000000000001000000000000000000000000000001
100000000000000000000000000001000000000000000000000000000001
100000000000000000000000000001000000000000000000000000000001
100000000000000000000000000001000000000000000000000000000001
100000000000000000000000000001000000000000000000000000000001
100000000000000000000000000001000000000000000000000000000001
100000000000000000000000000001000000000000000000000000000001
100000000000000000000000000001000000000000000000000000000001
100000000000000000000000000001000000000000000000000000000001
100000000000000000000000000001000000000000000000000000000001
100000000000000000000000000001000000000000000000000000000001
100000000000000000000000000000000000000000000000000000000001
100000000000000000000000000000000000000000000000000000000001
100000000000000000000000000000000000000000000000000000000001
100000000000000000000000000000000000000000000000000000000001
111111111111111111111111111111111111111111111111000000000001
100000000000000000000000000000000000000000000000000000000001
100000000000000000000000000000000000000000000000000000000001
100000000000000000000000000000000000000000000000000000000001
100000000000000000000000000000000000000000000000000000000001
100000000000000000000100000000000000000000000000000000000001
100000000000000000000100000000000000000000000000000000000001
100000000000000000000100000000000000000000000000000000000001
100000000000000000000100000000000000000000000000000000000001
100000000000000000000100000000000000000000000000000000000001
100000000000000000000100000000000000000000000000000000000001
100000000000000000000100000000000000000000000000000000000001
100000000000000000000100000000000000000000000000000000000001
100000000000000000000100000000000000000000000000000000000001
100000000000000000000100000000000000000000000000000000000001
100000000000000000000100000000000000000000000000000000000001
100000000000000000000100000000000000000000000000000000000001
100000000000000000000100000000000000000000000000000000000001
100000000000000000000100000000000000000000000000000000000001
100000000000000000000100000000000000000000000000000000000001
100000000000000000000100000000000000000000000000000000000001
111111111111111111111111111111111111111111111111111111111111

111111111111111111111111111111111111111111111111111111111111
100000000000000000000000000000010000000000000000000000000001
100000000000000000000000000000010000000000000000000000000001
100000001111111111111111111111111111111111111111111111000001
100000111111111111111111111111110000000000000000000000000001
100000100000000000000000000000010000000000000000000000000001
100011000000000000000000000000010000000000000000000000000001
100110000000000000000011001100010000000000000000000000000001
100000000000000000000000000100010000000000000000000000000001
100000000000000000000000000100010000000000000000000000000001
100000000000000000000000000100010000000000000000000000000001
100000000000000000000000011100010000000000000000000000000001
100000000000000000000000000100010010110001100000000000000001
100000000000000000000000000100010010000000000000000000000001
100000000000000000000000000100010010000000000000000000000001
100000000000000000000000000100010010000000000010000000000001
100000000000000000000011000100010010000000000000000000000001
100000000000011111100000000100010010000000000000000000000001
100000000000000000000000000100010010000000000000011000000001
100000000000000000000000000100010010000000000000000000000001
100000000000000000000000000100010001000000000000000000000001
100000000000000000000000011100010001000000000000000000000001
100000000000000000000000000100010000111111111111111111111111
100000000000000000000000000100011000100000000000000000000001
100000000000000000000000000100010000000000000000000000000001
100000000000000000000000000100010000000000000000000000000001
100000000000000000000011000100010000000000000000000000000001
100000000000000000000000000100010000000000000000000000000001
100000000000000000000000000100010000000000000000000000000001
100000000000000000000000000100010000000000000000000000000001
100000000000000000000000000100010000000000000000000000000001
111111111111111110000000010100010000000000000000000000000001
100000000000000000000000000100010000000000000000000000000001
100010000000000000000000000100010000000000000000000000000001
100010000000000000000000000100010000000000000000000000000001
100010000000000000000000000100010000000000000000000000000001
100011111111111111111111111100010000000000000000000000000001
100000000000000000000000000000010000000000000000000000000001
100000000000000000000000000000010000000000000000000000000001
111111111111111111111111111111111111111111111111111111111111